1111111
1PCS001
1000001
1000001
1000001
1111111
