111111111
1PCE11100
100000111
111111111
