11111111111111
10000000000CE1
10000000000001
10000000000001
10000000000001
10000000000001
10000000000001
10000000000001
10000000000001
1P000000000001
11111111111111
