11111111111111
10000111000CE1
10000010000001
10000000000001
10000000000001
111000P0000111
10000000000001
10000000000001
10000011000001
10001110000001
11111111111111
