11111111111111
10000000CCCCE1
100C0000000001
10000000C00001
100P000000C001
100000000000C1
11111111111111
