11111111111111
1P000000000001
11111000011111
1000CCC0000C01
10000000000001
10000000000001
1000C0000000E1
11111111111111
