11111111111111
1CCCCCCCCCCCE1
1CCCCCCCCCCCC1
1CCCCCCCCCCCC1
1CCCCCCCCCCCC1
1CCCCCCCCCCCC1
1CCCCCCCCCCCP1
11111111111111
