111111111
1P0C00111
111101111
1111000E1
111111111
