11111111111
1PCE0000001
10000000001
10000000001
10000000001
00000011111
