1111111111111111
1P000000000C00C1
1000000E0C000001
10C0000000000001
100C000000000001
1111111111111111
