111111111
1PC000001
100000001
100000001
100000001
111111111
