111111111
10CE00001
100000001
100000001
100000001
111111111
