1111111111111111
1000000000000001
1000000000000001
1111100000001111
1111111111111111
1111111111111111
1PCE000000000001
1111100000001111
1111111111111111
