1111111111111111
1000000000000001
1000000000000001
1000000000000001
1000000000000001
10000000AAA00001
1111111111111111
