1111111111111111
1000000000000001
10P00000000S0001
100C00C0000S0001
10000000E00S0001
1111111111111111
