1111111111111111
1P000000000000E1
10000000CCC00001
1111111111111111
1111111111111111
1111111111111111
1111111111111111
1111111111111111
1111111111111111
1111111111111111
1000PPP00E000001
1111100000001111
1111111111111111
