1111111111111111
1000000000000001
1000000000000001
1000000000000001
1000000000000001
AAAAAAAAAAAAAAAA
1111111111111111
