111111111
1PCE11111
100000111
111111111

111111111
100000001
100000001
100000001
111111111
