111111111
1PCE00001
100000001
000000000
100000001
111111111
