111111111
100000001
10P0C0001
111111111
1CCCCCCC1
1000E0001
111111111
