11111111111
1PC00000001
10000000001
10000000111
100000001E1
11111111111
