11111111
1P0000E1
10000001
10000111
100001C1
11111111
