11111111111
1PCE0000001
11111111111
1CCCC000001
10000000001
11111111111
