11111111111
1EC00000001
10000000001
10000000111
100000001P1
11111111111
