111111111
1P1000001
1110C0001
111111111
1CCCCCCC1
1000E0001
111111111
