111111111
100010001
10P010001
1CCC1CCC1
1001E0001
111111111
