1111111111111111
1PCE000000000001
111111111111111
