1111111111111111
1PCE000000000001
1000000000001
10000000001
1000000000001
1111111111111111
