00000011111
1PCE0000001
10000000001
10000000001
10000000001
11111111111
