1111111111
1P00000001
1000000001
1000CCE001
1000000001
10NNNNNNN1
1111111111
