111111111
1P00C00E1
100000001
100000CC1
100000CN1
111111111
