111111111
1P00C00E1
100000001
111111111
1000001N1
111111111
