111111111111111111111111111111
1P00010C1000001C000001110101C1
100001011000001000000000111101
100101010000001000010000000001
100100000000000000001001111111
100111111000011111001000E00001
1C1100000000N0C011111000000011
111111111111111111111111111111
