1111111111111111111
1P000000000000000C1
1111111111111111101
1111111111111111101
11111111111111111N1
1111111111111111101
1111111111111111101
1E000000000000000C1
1111111111111111111
