111111111
1P00C00E1
1000000C1
100000001
1000CC0N1
111111111
