111111111
1P00C00E1
10000CCC1
10000CNC1
10000CCC1
111111111
