111111111111
1P00000000E1
100000000001
1000CCCC0001
1000CN0C0001
1000CCCC0001
100000000001
111111111111
