111111111111
1P0000000001
100000000001
1000CCC00001
1000ENC00001
111111111111
