11111111111
1P1C0000001
10011111001
100CCCCC101
100C0N0C001
100CCCCC101
10100000101
1C1000001E1
11111111111
