11111111111
1P000000001
10000000001
10000ECCCC1
10000000001
1N000000001
11111111111
