11111111111111111111
1P0011C11C11111C11E1
10101101000111000101
10100100CCC010000101
10100100CNC00000C101
10110000CCC001111101
1C111000000000000001
11111111111111111111
