11111111111
1P000000001
10000000001
10000ECCCC1
1CC00000001
1NC00000001
11111111111
