1111111111
1P000000N1
1111111101
1111111101
1111111101
11111111C1
1E00000001
1111111111
