11111111111111
1P001C11C111E1
10101010001101
1010000CCC0101
1010000CNC0001
1C10000CCC00C1
11111111111111
